oooooo          ▓▓▓▓▓▓                      ▓▓                        
oooooo▓▓  ▓▓  ▓▓  ▓▓  ▓▓▓▓▓▓▓▓▓▓▓▓  ▓▓▓▓▓▓▓▓      ▓▓  ▓▓  ▓▓  ▓▓▓▓▓▓  
oooooo▓▓  ▓▓▓▓                  ▓▓  ▓▓      ▓▓▓▓▓▓▓▓  ▓▓  ▓▓      ▓▓  
▓▓          ▓▓  ▓▓  ▓▓▓▓▓▓▓▓▓▓  ▓▓  ▓▓▓▓▓▓  ▓▓      ▓▓        ▓▓▓▓▓▓  
    ▓▓▓▓▓▓  ▓▓▓▓▓▓▓▓▓▓          ▓▓        ▓▓▓▓  ▓▓  ▓▓  ▓▓▓▓      ▓▓  
▓▓  ▓▓                ▓▓▓▓▓▓▓▓  ▓▓  ▓▓▓▓  ▓▓    ▓▓  ▓▓        ▓▓▓▓▓▓  
    ▓▓  ▓▓▓▓▓▓▓▓▓▓▓▓                    ▓▓▓▓  ▓▓    ▓▓  ▓▓▓▓▓▓    ▓▓  
▓▓  ▓▓                ▓▓▓▓▓▓  ▓▓▓▓▓▓▓▓  ▓▓    ▓▓▓▓  ▓▓  ▓▓    ▓▓      
    ▓▓▓▓▓▓▓▓▓▓▓▓▓▓▓▓▓▓    ▓▓  ▓▓        ▓▓  ▓▓      ▓▓  ▓▓  ▓▓▓▓▓▓▓▓  
▓▓                  ▓▓▓▓▓▓▓▓  ▓▓  ▓▓▓▓  ▓▓  ▓▓▓▓▓▓  ▓▓  ▓▓            
▓▓  ▓▓  ▓▓▓▓▓▓▓▓▓▓▓▓          ▓▓    ▓▓  ▓▓▓▓        ▓▓  ▓▓  ▓▓▓▓▓▓▓▓▓▓
▓▓▓▓    ▓▓          ▓▓  ▓▓▓▓    ▓▓  ▓▓      ▓▓▓▓  ▓▓▓▓                
▓▓▓▓▓▓    ▓▓▓▓▓▓▓▓▓▓▓▓  ▓▓  ▓▓  ▓▓  ▓▓▓▓▓▓    ▓▓  ▓▓  ▓▓▓▓▓▓▓▓  ▓▓▓▓  
      ▓▓▓▓          ▓▓  ▓▓  ▓▓      ▓▓    ▓▓▓▓▓▓  ▓▓        ▓▓        
  ▓▓  ▓▓  ▓▓▓▓▓▓▓▓▓▓▓▓  ▓▓  ▓▓▓▓▓▓  ▓▓            ▓▓  ▓▓▓▓▓▓    ▓▓▓▓  
  ▓▓  ▓▓                ▓▓          ▓▓▓▓▓▓▓▓▓▓▓▓      ▓▓    ▓▓        
  ▓▓  ▓▓  ▓▓▓▓▓▓▓▓▓▓▓▓  ▓▓  ▓▓▓▓▓▓                ▓▓  ▓▓▓▓  ▓▓  ▓▓▓▓  
  ▓▓  ▓▓  ▓▓        ▓▓  ▓▓  ▓▓    ▓▓▓▓▓▓▓▓▓▓▓▓▓▓▓▓          ▓▓        
  ▓▓  ▓▓  ▓▓▓▓▓▓▓▓  ▓▓      ▓▓  ▓▓              ▓▓▓▓▓▓▓▓▓▓  ▓▓  ▓▓▓▓  
  ▓▓  ▓▓  ▓▓        ▓▓▓▓  ▓▓▓▓  ▓▓  ▓▓▓▓▓▓▓▓  ▓▓                  ▓▓  
  ▓▓  ▓▓  ▓▓  ▓▓▓▓▓▓      ▓▓    ▓▓        ▓▓  ▓▓▓▓▓ ▓▓▓▓▓▓▓▓  ▓▓▓▓    
  ▓▓  ▓▓  ▓▓  ▓▓  ▓▓  ▓▓▓▓  ▓▓▓▓▓▓▓▓  ▓▓  ▓▓                ▓▓▓▓▓▓  ▓▓
  ▓▓  ▓▓  ▓▓  ▓▓  ▓▓  ▓▓▓▓            ▓▓  ▓▓  ▓▓▓▓▓▓▓▓▓▓▓▓▓▓      ▓▓  
  ▓▓▓▓              ▓▓      ▓▓▓▓▓▓▓▓  ▓▓  ▓▓                ▓▓▓▓▓▓▓▓  
      ▓▓▓▓▓▓▓▓  ▓▓  ▓▓  ▓▓            ▓▓  ▓▓▓▓▓▓▓▓▓▓▓▓▓▓▓▓▓▓          
  ▓▓        ▓▓  ▓▓  ▓▓  ▓▓  ▓▓  ▓▓  ▓▓                    ▓▓  ▓▓▓▓  ▓▓
  ▓▓▓▓▓▓▓▓▓▓▓▓      ▓▓  ▓▓  ▓▓  ▓▓  ▓▓  ▓▓▓▓▓▓▓▓▓▓▓▓▓▓▓▓  ▓▓  ▓▓▓▓    
              ▓▓▓▓  ▓▓  ▓▓  ▓▓  ▓▓▓▓  ▓▓              ▓▓  ▓▓      ▓▓  
▓▓▓▓▓▓▓▓  ▓▓        ▓▓  ▓▓  ▓▓▓▓  ▓▓  ▓▓  ▓▓▓▓▓▓▓▓▓▓  ▓▓    ▓▓▓▓▓▓    
          ▓▓▓▓▓▓▓▓  ▓▓  ▓▓        ▓▓  ▓▓  ▓▓          ▓▓  ▓▓      ▓▓  
  ▓▓▓▓▓▓  ▓▓              ▓▓  ▓▓      ▓▓  ▓▓  ▓▓  ▓▓  ▓▓▓▓  ▓▓  ▓▓▓▓  
          ▓▓  ▓▓▓▓▓▓  ▓▓  ▓▓  ▓▓  ▓▓  ▓▓  ▓▓  ▓▓  ▓▓        ▓▓  ▓▓    
  ▓▓▓▓▓▓▓▓▓▓      ▓▓  ▓▓  ▓▓  ▓▓  ▓▓      ▓▓  ▓▓  ▓▓  ▓▓▓▓▓▓  pppppp  
            ▓▓▓▓  ▓▓      ▓▓    ▓▓  ▓▓▓▓  ▓▓▓▓▓▓▓▓▓▓          pppppp  
  ▓▓▓▓▓▓▓▓    ▓▓  ▓▓▓▓▓▓▓▓▓▓▓▓▓▓  ▓▓    ▓▓          ▓▓▓▓  ▓▓▓▓pppppp 
